2 13 31
###############################
#p  **  * *  1 * 2 *  * * *   #
#*# # #*# # #*#*# # # #*#*#*# #
# 2**     *s*  *  1   * 2 * * #
# # #x# # #*# # #*#*# # # # #*#
#*          * **  *  *   1   f#
#1# # # # # # # # #*# #*# # # #
#*  *      * * *      *       #
# # # # #*# # # #*#*# # # # # #
#*    ** 1*  b    *           #
#2#*# # # # # # #*# # # # # # #
#           *   *  *          #
###############################